%%%%%%%%%%%%%%%%
%%......G.....%%
%  %..%%%%..%  %
%  %..%%%%..%  %
%  ....P.....  %
%%%%%%%%%%%%%%%%