%%%%%%%%%%%%%%%%%%%%
%....%........%....%
%.%%.%.%%%%%%.%.%%.%
%.%G............G%.%
%.%.%%.%%  %%.%%.%.%
%...%%%%....%%%%...%
%.%.%%.%%  %%.%%.%.%
%.%..............%.%
%.%%.%.%%%%%%.%.%%.%
%....%...P....%....%
%%%%%%%%%%%%%%%%%%%%
