%%%%%%%
% P  o%
% %%% %
% %.  %
% %%% %
%. G  %
%%%%%%%
